################
#!.............#
#..............#
#..............#
#..............#
#......###X#####
#O.....#.......#
########....<..#
#..............#
#..............#
#.............!#
#O.....?.......#
################
