################
#!............X#
#..............#
#..............#
#..............#
#..............#
#O.............#
#...........<..#
#..............#
#..............#
#.............!#
#O.....?.......#
################
