################
#!.....O#.....O#
#.......#......#
#.......#......#
#.......#.....O#
#.....#####X####
#.....#........#
####X####.._<..#
#......O#.___..#
#.......#......#
#.......#.....!#
#O.....?#$..O..#
################
