################
#!....O#......?#
#......#.......#
#......#O......#
#......####X####
#......#.......#
#......#.......#
#O.....#..._<..#
#####X##..___..#
#..............#
#.............!#
#O.............#
################
