################
#!.....O#.....O#
#.......#.._<..#
#.......#.___..#
#.......#O.....#
#.....######X###
#.....#........#
####X####.._<..#
#O.....?#.___..#
#.......#......#
#.......#.....!#
#O......#...O..#
################
